111111111111111111111111111111
100000000100000000001000000001
101100100000110011000001001101
100001101010000000010101100001
101111001010111111010100111101
100100000000000000000000001001
100001110001110011100011100001
101111110101000000101011111101
100001110101011110101011100001
101100000100001100001000001101
101100111111100001111111001101
100000111111101101111111000001
101110000100000000001000011101
100000110101110011101011000001
111111110001000000100011111111
111111110001000000100011111111
100000110101111111101011000001
101110000100000000001000011101
100000111111101101111111000001
101100111111100001111111001101
101100000100001100001000001101
100001110101011110101011100001
101111110101000000101011111101
100001110001110011100011100001
100100000000000000000000001001
101111001010111111010100111101
100001101010000000010101100001
101100100000110011000001001101
100000000100000000001000000001
111111111111111111111111111111