11111111111111111111111111111
10000000000000000000000000001
10111011111101110111111011101
10101000000001010000000010101
10111011111101010111111011101
10000010000000000000001000001
10111110111111111111101111101
10000000111111111111100000001
10111110000000100000001111101
10000011111101110111111000001
10111000000100100100000011101
10001111110110101101111110001
10100000010100100101000000101
10111111010101110101011111101
10100001000000000000010000101
10100001010101110101010000101
10111111010100100101011111101
10100000010110101101000000101
10001111110110101101111110001
10111000000100100100000011101
10000011111101110111111000001
10111110000000100000001111101
10000000111111111111100000001
10111110111111111111101111101
10000010000000000000001000001
10111011111101010111111011101
10101000000001010000000010101
10111011111101110111111011101
10000000000000000000000000001
11111111111111111111111111111

G-14-3-RED;G-14-26-RED;G-14-1-RED;G-14-28-RED;P-14-14